RgbRfButton	KEYWORD1
Power	LITERAL1
ModePlus	LITERAL1
SpeedMinus	LITERAL1
Demo	LITERAL1
SpeedPlus	LITERAL1
ColorPlus	LITERAL1
ModeMinus	LITERAL1
BrightPlus	LITERAL1
ColorMinus	LITERAL1
White	LITERAL1
BrightMinus	LITERAL1
Red	LITERAL1
Green	LITERAL1
DarkBlue	LITERAL1
Yellow	LITERAL1
LightBlue	LITERAL1
Pink	LITERAL1
RgbRfCode	KEYWORD1
RgbRfReceiver	KEYWORD1
RgbRfReceiverCallBack	KEYWORD1
RgbRfReceiverCallBackKEYWORD1
isReceiving	KEYWORD2
init	KEYWORD2
enable	KEYWORD2
disable	KEYWORD2
deinit	KEYWORD2
RgbRfTransmitter	KEYWORD1
sendButton	KEYWORD2